##########################
#........................#
#...............##########
#...............#........#
#.#.#.#.#................#
#...............#........#
#.#.#.#.#.......##########
#........................#
#........................#
#........................#
#........................#
#........................#
#................####.#..#
#...................#....#
#...................#....#
#........................#
##########################