11111111111111111111111111
10000000000000000000000001
10000000000000003333333331
10000000000000003000000001
10202020200000000000000001
10000000000000003000000001
10202020200000003333333331
10000000000000000000000001
10000000000000000000000001
10000000000000000000000001
10000000000000000000000001
10000000000000000000000001
10000000000000000231203001
10000000000000000000300001
10000000000000000000100001
10000000000000000000000001
11111111111111111111111111