11111111111111111111111111
10000000000000000000000001
10000000000000002222222221
10000000000000002000000001
10202020200000000000000001
10000000000000002000000001
10202020200000002222222221
10000000000000000000000001
10000000000000000000000001
10000000000000000000000001
10000000000000000000000001
10000000000000000000000001
10000000000000000221202001
10000000000000000000200001
10000000000000000000100001
10000000000000000000000001
11111111111111111111111111