R R R R R R R R R
R 0 0 0 0 0 0 0 R
R 0 I 0 I I I 0 R
R 0 I 0 I 0 0 0 R
R 0 I I I I I 0 R
R 0 0 0 I 0 I 0 R
R 0 I I I 0 I 0 R
R 0 0 0 0 0 0 0 R
R R R R R R R R R