V V V V V V V V V
V 0 0 0 0 0 0 0 V
V 0 G G 0 0 0 0 V
V G 0 0 0 0 0 0 V
V G 0 0 0 0 0 0 V
V 0 G G 0 0 0 0 V
V 0 0 0 0 0 0 0 V
V 0 0 0 0 0 0 0 V
V V V V V V V V V